#############################        ###########################
#                                                              #
#            #      #    #                                     #
#            #      #    #                                     #
#            #      #    #                                     #
#            #      #    #                                     #
#            #      #    #                 #   #   #           #
#                                          #   #   #           #
#                                          #   #   #           #
                                           #   #   #            
                                           #   #   #            
                                                              
                                              
#                                                              #
#                                                              #
#                ################################              #
#                                                              #
#                                                              #
#                ################################              #
#                                                              #
#                                                              #
#                                                              #
#############################        ###########################