################################################################
                                                              
#                                                              #
#                   #        #                  #########      #
#                   #        #                      #          #
#                   #        #                      #          #
#                   ##########                      #          #
#                   #        #                      #          #
#                   #        #                      #          #
#                   #        #                      #          #
#                                                              #
#                                                              #
#     #      #                         ######    ######        #            
#     #    # #                         #              #        #
#     #   #  #                         #              #        #
#     # #    #                         #######  #######        #
#     #      #                                                 #    
#                                                              #    
#                                                              #
#           ############                                       #
            #          #                                        
                                                              
################################################################