################################################################
#                                                              #
#                                                              #
#                   #                          #########       #
#                   #                                          #
#                   #                                          #
#                   ###########                                #
#                             #                                #
#                             #                                #
#                             #                                #
#                                                              #
#                                                              #
#                                   #             #            #
#                                   #             #            #
#                                   #             #            #
#                                   ####       ####            #
#                                                              #
#                                                              #
#                                                              #
#           ############                                       #
#                                                              #
#                                                              #
################################################################